1111111111111111111111111
10001000000C0000000010001
100C10000000000000001C001
1001100000000000000111001
100000000T000000000010001
1000000011110000000000001
1000000000000000000000001
1000000000000011110000001
100000000000000C100000001
1000010000000000100000001
100001C000010000000P00001
1001111100111000000000001
1000000100010000000000001
100000E100C100000000000C1
1111111111111111111111111
