1111111111
10C1000011
1000110001
100000P001
1110000001
1100000T01
1E00000111
1111111111
